111111111111111111111111111111111111111111111111111111111111111111111111111111111111111111111111111111111111111111111111111111111111111111111111111111111111111111111111111111111111111111111111
100000100010000000000010001000000000000010000010000110000001011101101000000000101110000010000000000000100000001000000000010000000100000000000010000011100000000000001100001000000000010001010001
100001000001000010000001000010010000000001000101000101100100000001000000000100000000100101000000000010000011111000001000000010010000010000000000000001010010000000010010010100000000010000011001
101000000011100001001000000001001000010011000100010100000001000000101000001000001100001000000000001001000000000000010000000000000001000100100000000001001100000001000000000000000000000101000001
110000000000001000000001000000000000000000000100000000011001101001011000100100001000100000000100000001000000100001000100010000000010000000000000000010010010000000000010000110000010000000000001
100000100000000000111000000000000000000000000000010000000100010010000000000000000000000010001000010100010010000000010000010000000000100000011000000000000100100000011101000000000000101000011001
100000000100000001010010010010000000000000010000000000100000000001000001000001010110010000010101001100011000000000110000000100010000000001000100001000000000001000001000010000101000001100001011
111100000100000000000100001000000010010000000000000011001000000000001000000000000000000000010000011011000100000000100000000000010100000000000001001000000011100000000000001101100000000100000101
100100000100100000101000010010000000100000001000000100001000010011000000000000001000011000110101000000000100000000000000000000000000100000101000100010001000100100001000000001000010001011001001
100000010010000100011100010000000000000000010001000000001000010000100000000000100000000000010110000000000000000000000001000000001000001001001000000010000001010000000000000000000100000001010001
111011010000010000000000000000000100100000000000000000000001000000000000101001000001001010000000000000000000001000000011001001100010010000101000101000000000000000100100000011000000000010000001
110000000000111100001010000010000000000000010000001000010010001000010100000000000001010000000010000000000000100010001010001100010000000000000000100101000000000100010011001001000010010000000001
100001000000100000000000000100100000010011000000000001000000000000100000001110000001000000000000101000010000000000100000000100000001000000000000000000000000000000000000000000000110000100000001
100000001000001010000000001000000001000000000010000000100000110001100010010010000000000000000001100000010000000100000000101000000001000101100000100000000001000010001000000110000000000000010001
100000101000100000100000000100000000001000000000010000000000110000000000010000000001001000001001100001000000000000000000000000000000000010101000000000010100000000000000110100000011001010000001
110000000100000100000000001000000100000000101100110100000100000000000001010000000000000010000100000000001000000000000000001000000000110000100000000000001001000000000010100000000000010100101101
100000000011010000000000000011000001001100011000000001000000000010010100011000010010000000000100000000000010000010001000000000000111011010000000011100101000000000000000010100100001010001000001
100011000010101010000000101010100010000100010101100001010000000100000000001001101010000000000000000000010101001000000000101000000000001000000000000000000000000000000000000010000110000100010001
111000001000000000100000000000000100110000000011001000001000000100100000100000000001001000000000000100000100000000000000011010001001000000100000000000000000100000001000000000010000000100000001
100010000000000100000000000000110100001000001000000000000101000000000100000000000010000000000000000001000000010010000000110000010000000010010000000000000000001000110000100001000000010000000001
110101100000000011000000000000000010000000100000010001100101000100001001100000000000010000100100000000000100000000001000010000001100000000000000100010000001000001100000000010001100000000010101
110000000000000000000010011010000000000000000001000010000000000100001000000000001000000000000000000000000001000110000100101000000000100000100001001100000000001010100011000000001010001000000001
110000000010000000100000000000000000000100000000000010000000010000101000000001000001010000001000000000000000011000000000000000000100000000000001001000000000000010000010110000100000000000100001
110100010000110000010010000000110000010000000100100000000000001001100000001000000000100000000000010000000001000001000000000101000000100000001010101000000000000001000000000100000010110011010011
101010000000100000000001000001000000000001010010010110100110100000110000000000100101100000000000100000000000000001100000010000001100010000000100110100000100000100100000000001001100000010000001
110000000000000000001000001000000000000010000000000000001000000000000000000001100001000000000010101001000100100100000000000000000000011000000000100001000000000100000000010000001000100000001001
101100000010000010000000000000010010000010010000000100000000000010000000010100000100010100000010000000111000000000000000000000000110000000000000010110000000100000001000000001010000000101001001
101000000000010000000110101000001100100001101010100000010000100000000000000100000000000001000000000000000000101010000000000000000000000000000000000000000000000000100100001000000000000000000001
100100100000000000100000000000000000000000000000010001000000000000000000000001000000000000000010000010000100010100000011100000000000000000000010000100001100100101000010100000000000001000000101
101100000010000000000000000000001000000000000000000000000000000000000000010000010010001000000100001000000000000000001000000000001010010000000001000000000000000011000100000000001000001010101101
100001010000000000000100000001001001010000000001100000001010001000000100000000000000000000110000000100011110000010001100011000000000000010010000000011000000000000010010010100000000000000011101
100000000100000001101000000001001000100000000001000000010110000000000001000000000000000000010000001010001000000001000100100001000000000000000000000000001000001000000010000000010100100000010001
100000001000000000000000001000000010010000000000000000000001000000000001000010000000000000011100000000001011001010000000000000000000000000000000000000000000011000000000000000000000000000000001
100011000000000000001010000000001010000101000000100010001000000110000001000001000010000101000000000100000000010000000010000000100000001000100000010010000000000000100001000000000001110000100001
101100000010000000000010001000010010000000000101010000000001000010000000000000000000101000000000000000000000000001000001000000000001000100000000101000000000000000100000001000010001100000010101
100000000000000000000010011000000001000000010001100001000001000000000001000000010001010000000100000000000101000101000001100100000000000000000000000101000011001010100100000100000011000001000001
100100001000010000100011001000000000000000000101010000000100000001000011010100100000001000100000000010010010000000000010000000000000000000100000001000001000101000000000010000001010000010000001
100000100011000100000000101000010000000000100000000100000010000000000000010010000000000001001000100100000000000010000000000010110000000010000000000001000000000101010000010000000000000000000001
100001100000010001000001000001000000000000010100101000001000000000001000001000000000100000001101010000001000000001000000010000010000000010000000100000000000000000010000000001000011000000100001
100000001100000000000000000001100000011000001100000000000000100000001000000110000000000000010001000101000010000100000000000000000000100010000001000000000000000000000000100000100000000001000011
101000010010001000000000000000100000000000000001100000000000010001000000010010100001100000000100000000000000000011000000010001000000000000010000000110000000000000100000000011010000000000000001
100000001100011100000011000001000000000000100011000000000000000010000001000000110000000000000000010110000000010000000010000000000000000000010000000000001000000010000000100000001000000000001001
100010000000000000000000000000110010000000110001101010000000100000000000010000001010000000000000000000100010000000000100000000000000000000000010010000000000001000000001001000001000100001000101
100000000000000000001001000000001000000000010001001000001000100100000000000111000000110001000001000000000000010001001010000000000000000100000001000000000000001100100000000000000000001000011001
100100000001000010000000100100010001100100000000100001000000000010000010010010000000000000000000000000000000000001000001000000000000000001000000010000000000001000001000000000000000001000001001
110000100001000011000000000000000000010000000100010100010001011000000000000011000001011000000110000011000010000000000000010100000000100000000100000100001000100100000000000000000000000000010001
100001001001000000001001010000001000000000000001100000000000000010000000000110000100000000000000001000000000000101000010000001010010000000001001000000000100000000001000000000000000000101000011
101001000100000000100101000000100000000000000000000000000001000010000010000000000101000011011000000000000000000001000100000100010000000101010010001000010000000000000010100100000000000001100011
111100110000000010000110000000100001000110000000000100100000001000100000000000001101110100010100100000000010000000010000000100000010000011010100000000000000000000000010000001000010000000000001
100010000000100000000000010010000000000000000000000100000000000001000001000000000000000000000010000000000000000000000000000100100000010010000000000000000000100000000000000010010100011011100001
101010000010000011100100000001000000000000000100010000100001010010001000100010000100000000000010000000000000000000010000000000000111001010000000000000001001001000001010100000000000100100000001
100001000011000100010000100000101000001000010010000001000000000000000001000000100000000000011000010010000010110000000000001110110000000001000000010000000000000000100011000010000100000000010001
100001000000101110000000010010000000000000001000000100000000100000000000100010010000000110000000000100000000000000010000000100000000000100001100000000100000100000000000000000001000000000110001
100000000000000000000100001000001000000000000000010000010000100001000001000000010000000000100100010000010000000010010000000101000000000010001010100000000000000001100000000100100010000001100001
100000000000100010001010000000000000000000000000000100000000000000001000000000000100100000001110000010001000000000000000000010000100000000010000110000000101000000000000100011000000000010000001
100000000000000000000100100000010000000111000001100000000000000001010000001000001110000001010000001000000001100000100010000000000110000100001000000000000000000000000010000001000000000000010001
110001000000000000001001001000000100000001000010000000000100000000010100001100000000000000000001000000010000010001000001000001000101000000000001000000001100001000000100000000011000100101000001
100000000000100100000000000000000000000001000000000000101010000000000000000000000000000010100100100000001000000000101000000000010000000110000010000000000000100000000000100110100000000000001101
100000011100000000000000000000101000000010000000000010110010000100000000001000000000000000000000100000000000101000100000000011001000000010101000000000001100010000000010000010000101011000010001
100000000000000000100100000000001000000000001100000001010010001000000010100000000001000000000000100000000000011000001010010000000000101000001100100110011010000001000001101100000100001100000001
100010000000000000000000000000000000000000100000000000111000000000000110001100000000100000000000000000100101010000000000000000010001000100000010000000000100000000000010010011000000000000000101
100000100000100000000000000001000000010100010001010001000000001000010000000011000000100000000010100100000000000000100000100000001000000000000001100000001001001000010000000000000010001010000101
111111111111111111111111111111111111111111111111111111111111111111111111111111111111111111111111111111111111111111111111111111111111111111111111111111111111111111111111111111111111111111111111
