000000000000000000000000000000000000000000000000000000000000000000000000000000000000000000000000000000000000000000000000000000000000000000000000000000000000000000000000000000000000000000000000
000000000000000000000000000000000000000000000000000000000000000000000000000000000000000000000000000000000000000000000000000000000000000000000000000000000000000000000000000000000000000000000000
000000000000000000000000000000000000000000000000000000000000000000000000000000000000000000000000000000000000000000000000000000000000000000000000000000000000000000000000000000000000000000000000
000000000000000000000000000000000000000000000000000000000000000000000000000000000000000000000000000000000000000000000000000000000000000000000000000000000000000000000000000000000000000000000000
000000000000000000000000000000000000000000000000000000000000000000000000000000000000000000000000000000000000000000000000000000000000000000000000000000000000000000000000000000000000000000000000
000000000000000000000000000000000000000000000000000000000000000000000000000000000000000000000000000000000000000000000000000000000000000000000000000000000000000000000000000000000000000000000000
000000000000000000000000000000000000000000000000000000000000000000000000000000000000000000000000000000000000000000000000000000000000000000000000000000000000000000000000000000000000000000000000
000000000000000000000000000000000000000000000000000000000000000000000000000000000000000000000000000000000000000000000000000000000000000000000000000000000000000000000000000000000000000000000000
000000000000000000000000000000000000000000000000000000000000000000000000000000000000000000000000000000000000000000000000000000000000000000000000000000000000000000000000000000000000000000000000
000000000000000000000000000000000000000000000000000000000000000000000000000000000000000000000000000000000000000000000000000000000000000000000000000000000000000000000000000000000000000000000000
000000000000000000000000000000000000000000000000000000000000000000000000000000000000000000000000000000000000000000000000000000000000000000000000000000000000000000000000000000000000000000000000
000000000000000000000000000000000000000000000000000000000000000000000000000000000000000011111111111111111111111100000000000000000000000000000000000000000000000000000000000000000000000000000000
000000000000000000000000000000000000000000000000000000000000000000000000000000111111111111111111111111111111111111111111110000000000000000000000000000000000000000000000000000000000000000000000
000000000000000000000000000000000000000000000000000000000000000000000001111111111111111111111111111111111111111111111111111111110000000000000000000000000000000000000000000000000000000000000000
000000000000000000000000000000000000000000000000000000000000000000111111111111111111100000001111111111111110000000000111111111111111100000000000000000000000000000000000000000000000000000000000
000000000000000000000000000000000000000000000000000000000000000111111001111111111111000000000111111111111111110000000000000000111111111110000000000000000000000000000000000000000000000000000000
000000000000000000000000000000000000000000000000000000000001110000000011111111111111000000000001111111111111111111111111111111110011111111110000000000000000000000000000000000000000000000000000
000000000000000000000000000000000000000000000000000000001111111111111111111111111100000000000000001111111111111111111111111111111100111111111110000000000000000000000000000000000000000000000000
000000000000000000000000000000000000000000000000000011111111111111111111111111110000000000000000000000111111111111111111111111111110001111111111101000000000000000000000000000000000000000000000
000000000000000000000000000000000000000000000000001111111111111111111111111100000000000000000000000000110000000001111111111111000000000011111111111110000000000000000000000000000000000000000000
000000000000000000000000000000000000000000000000011111111111111111111111111110000000000000000000001100000000000000000000000000001100000001111111111111000000000000000000000000000000000000000000
000000000000000000000000000000000000000000000000000100000000011000000000000000000100000000000000110000000000000000000000000000000001000000011111111111111000000000000000000000000000000000000000
000000000000000000000000000000000000000000000000000000000010000000000000000000000001000000000000100000011111111111111111111000000000100000001111111111111010000000000000000000000000000000000000
000000000000000000000000000000000000000000000000010000010000000000000000000000000000000000000000000111111111111111111111111111000000100000000111111111111111000000000000000000000000000000000000
000000000000000000000000000000000000000000000000100001000000000011111111111111111110000000000000011111111111000000000111111111110000000000000001111111111111011111101000000000000000000000000000
000000000000000000000000000000000000000000000001100010000000111111111111111111111111110000000000111111110000000000000011111111110000000000000000111111111110000000000011000000000000000000000000
000000000000000000000000000000000000000000001111000010000111111111111110000001111111111000000001111111000000000000000111111111110000000000000000011111110000000000000000011100000000000000000000
000000000000000000000000000000000001100000000000000000001111111111000000000000111111111100000001111111100000000001100000011111100000000000000000000111100000000000000000000011000000000000000000
000000000000000000000000000000100000000000000000000000011111111100000000000001111111111100000000111111111111111111000000011111000000000000000000000010000000000000000000000000110000000000000000
000000000000000000000000001000000000000000000000000000011111111100000000000110000001111000000000000111111111111111111111111100000000000000000000000000000000000000000000000000010100000000000000
000000000000000000000001000000000000000000000000000000001111111111000011111100000001100000000000000000001111111000000000000000000000000000000000000000000000000000000000000000001000000000000000
000000000000000000000100000000000000000000000000000000000011111111111111111111111110000000000000000000000000000000000000000000000000000000000000000000000000000000000000000000000100000000000000
000000000000000000010000000000000000000000000000000000000000011111111111100000000000000000000000000000000000000000000000000000000000000000000000000000000000000000000000000000000101000000000000
000000000000000000100000000000000000000000000000000000000000000000000000000000000000000000000000000000000000000000000000000000000000000000000000000000000000000000000000000000000101000000000000
000000000000000011000000000000000000000000000000000000000000000000000000000000000000000000000000000000000000000000000000000000000000000000000000000000000000000000000000000000001010000000000000
000000000000000010000000000000000000000000000000000000000000000000000000000000000000000000000000000000000000000000000000000000000000000000000000000000000000000000000000000000010100000000000000
000000000000000010000000000000000000000000000000000000000000000000000000000000000000000000000000000000000000000000000000000000000000000000000000000000000000000000000000000010010000000000000000
000000000000000010000000000000000000000000000000000000000000000000000000000000000000000000000000000000000000000000000000000000000000000000000000000000000100000000000111110000000000000000000000
000000000000000110000000000000000000000000000000000000000000000000000000000000000000000000000000000000000000000000000000000000000000000000000110000000001100000000000000000000000000000000000000
000000000000000001000000000000000000000000000000000000000000000000000000000000000000000000000000000000000000000000000000011111111110000000010000000000000001010000000000000000000000000000000000
000000000000000001000000000000000000000000000000000000000000000000000000000000000000000000000000000000000000000000001001100001100101000001000000000000000000010100000000000000000000000000000000
000000000000000000110000000000000000000000000000000000000000000000000000000000000000000000000000000000000000000011011000000100010101000010000000000000000000001110000000000000000000000000000000
000000000000000000011000000000000000000000000000000000000000001000000001000000000000000000000000000000000000001000010001100000011010110100000000000000000000000011000000000000000000000000000000
000000000000000000000110000000000000000000000000000000000001000000000000100000000000000000000000000000000000100010000010001001000100010000000000000000000000000001100000000000000000000000000000
000000000000000000000001110000000000000000000000000000000100000000000001000000000000000000000000000000000011000000001000100000010000100000000000000000000000000001010000000000000000000000000000
000000000000000000000000000110000000000000000000000000001000000000000010000000000000000000000000000000000100000000010000000010000001000000000000000000000000000000110000000000000000000000000000
000000000000000000000000000001010000000000000000000000010000000000001000000000000000000000000000000001111000000000100000010000000100000000000000000000000000000000100000000000000000000000000000
000000000000000000000000000000000101100000000000000000001000000011000000000000000000000000000111000000010000000001000000100011001000000000000000000000000000000000101000000000000000000000000000
000000000000000000000000000000000000000100110000000000000000000000000000000000000001111001000000000000000110011000000110000000000110000000000000000000000000000000101000000000000000000000000000
000000000000000000000000000000000000000000000010000001111111111111000000000000000010100000000000000000000000010000000000000000000000001000000000000000000000000000101000000000000000000000000000
000000000000000000000000000000000000000000000001000000000000000000000000000000000000000000000000000000000000110000000000000000000000000000000000000000000000000000001000000000000000000000000000
000000000000000000000000000000000000000000000000010000000000000000000000000000000000000000000000000000000001001100000000000000000000000000000000000000000000100000010000000000000000000000000000
000000000000000000000000000000000000000000000000000100000000000000000000000000000000000000000000000000000010000010000000000000000000000000000000000000000001000000010000000000000000000000000000
000000000000000000000000000000000000000000000000000011000000000000000000000000000000000000000000000000001000000001100000000000000000000000000000000000000010000000011000000000000000000000000000
000000000000000000000000000000000000000000000000000000010000000000000000000000000000000000000000000000100000000000010000000000000000000000000000000000001000000000010000000000000000000000000000
000000000000000000000000000000000000000000000000000001000010000000000000000000000000000000000000000001000000000000000100000000000000000000000000000000010000000000010000000000000000000000000000
000000000000000000000000000000000000000000000000000001000000010000000000000000000000000000000000000100000000000000000001000000000000000000000000000000100000000000010000000000000000000000000000
000000000000000000000000000000000000000000000000000001000000000011000000000000000000000000000000010000000000000000000000010000000000000000000000000010000000000000010100000000000000000000000000
000000000000000000000000000000000000000000000000000001100000000000001100000000000000000000000001000000000000000000000000000110000000000000000000010000000000000000010100000000000000000000000000
000000000000000000000000000000000000000000000000000000000000000000000000011100000000000000001000000000000000000000000000000000011000000000000010000000000000000000001100000000000000000000000000
